domain	political_leaning
newyorker.com	left
newrepublic.com	left
blackagendareport.com	left
thegavoice.com	left
pfaw.org	left
truthdig.com	left
queerty.com	left
nynmedia.com	left
mediamatters.org	left
vice.com	left
pnhp.org	left
rollingstone.com	left
gaystarnews.com	left
michael-arceneaux.com	left
glaad.org	left
marclamonthill.com	left
afro.com	left
refinery29.com	left
canyoncountryzephyr.com	left
jrlcharts.com	left
upworthy.com	left
blacknews.com	left
educationvotes.nea.org	left
teenvogue.com	left
jill.substack.com	left
peacock-panache.com	left
salon.com	left
msnbc.com	left
esquire.com	left
bostonglobe.com	left
care2.com	left
counterhate.com	left
ebony.com	left
aaihs.org	left
elipariser.org	left
cfr.org	left
rawstory.com	left
kansasreflector.com	left
theintercept.com	left
freepress.net	left
progressivevoicesofiowa.com	left
adaction.org	left
boltsmag.org	left
heralddemocrat.com	left
theatlantic.com	left
out.com	left
thechristianleftblog.org	left
jezebel.com	left
theminorityeye.com	left
nymag.com	left
jacobinmag.com	left
metroweekly.com	left
gaynewstoday.com	left
huffpost.com	left
bluevirginia.us	left
newsone.com	left
texassignal.com	left
chicagodefender.com	left
minnesotareformer.com	left
vogue.com	left
newpittsburghcourier.com	left
occupydemocrats.com	left
thenation.com	left
childrensdefense.org	left
ncpssm.org	left
vox.com	left
joemygod.com	left
thepinknews.com	left
alternet.org	left
epi.org	left
lgbtqnation.com	left
socialistalternative.org	left
motherjones.com	left
thesaintaq.com	left
um-insight.net	left
thegailygrind.com	left
disinformationindex.org	left
dailykos.com	left
aaronrupar.substack.com	left
slate.com	left
factcheck.afp.com	left
fcnp.com	left
politicususa.com	left
thinkprogress.org	left
aframnews.com	left
democracynow.org	left
buzzfeednews.com	left
hrc.org	left
lasentinel.net	left
tyt.com	left
cbpp.org	left
yesmagazine.org	left
splcenter.org	left
ajplus.net	left
blavity.com	left
arkansasonline.com	left
thedailybeast.com	left
sfchronicle.com	left
currentaffairs.org	left
nydailynews.com	left
blockclubchicago.org	left
phillytrib.com	left
boingboing.net	left
metrophiladelphia.com	left_center
bgdailynews.com	left_center
texastribune.org	left_center
independent.co.uk	left_center
wisconsingazette.com	left_center
alanrozenshtein.com	left_center
mndaily.com	left_center
lasvegassun.com	left_center
countercurrents.org	left_center
philly.com	left_center
loscerritosnews.net	left_center
thecity.nyc	left_center
politico.com	left_center
propublica.org	left_center
mississippifreepress.org	left_center
dailytargum.com	left_center
ohiocapitaljournal.com	left_center
commercialappeal.com	left_center
cbsnews.com	left_center
pres-outlook.org	left_center
theweek.com	left_center
vanityfair.com	left_center
tennesseelookout.com	left_center
sltrib.com	left_center
ips-dc.org	left_center
themainemonitor.org	left_center
transwrites.world	left_center
themaneater.com	left_center
bridgealliance.us	left_center
lmtonline.com	left_center
themississippilink.com	left_center
mediaite.com	left_center
truth-out.org	left_center
semafor.com	left_center
sandiegouniontribune.com	left_center
cnn.com	left_center
nbcboston.com	left_center
montanafreepress.org	left_center
theconversation.com	left_center
wisconsinwatch.org	left_center
kseholdings.com	left_center
missouriindependent.com	left_center
dailydot.com	left_center
gq.com	left_center
coloradotimesrecorder.com	left_center
insider.com	left_center
skyhidailynews.com	left_center
healthcare.gov	left_center
mercurynews.com	left_center
cadizrecord.com	left_center
psmag.com	left_center
centre-view.com	left_center
publicintegrity.org	left_center
nowthisnews.com	left_center
gizmodo.com	left_center
christiancentury.org	left_center
sacbee.com	left_center
meaws.com	left_center
bangordailynews.com	left_center
scientificamerican.com	left_center
amnesty.org	left_center
fair.org	left_center
newjerseymonitor.com	left_center
sgn.org	left_center
theroot.com	left_center
vtdigger.org	left_center
thecharlottepost.com	left_center
riverfronttimes.com	left_center
washingtoninformer.com	left_center
kwit.org	left_center
diversityinc.com	left_center
americanprogress.org	left_center
hollywoodreporter.com	left_center
goodfaithmedia.org	left_center
masslive.com	left_center
marylandmatters.org	left_center
naacp.org	left_center
blackenterprise.com	left_center
upnorthnewswi.com	left_center
today.com	left_center
epgn.com	left_center
insidehighered.com	left_center
kansasreflector.com	left_center
mainepublic.org	left_center
prwatch.org	left_center
edf.org	left_center
whitehouse.gov	left_center
startribune.com	left_center
hbswk.hbs.edu	left_center
capeandislands.org	left_center
southernmarylandchronicle.com	left_center
theblockcharlotte.com	left_center
politifact.com	left_center
democrats.org	left_center
sfgate.com	left_center
eriegaynews.com	left_center
aljazeera.com	left_center
wisconsinexaminer.com	left_center
mankatofreepress.com	left_center
cbc.ca	left_center
politicspa.com	left_center
JesterOfThePeace.com	left_center
aclu.org	left_center
michiganchronicle.com	left_center
leadstories.com	left_center
ctnewsjunkie.com	left_center
hstoday.us	left_center
courier-journal.com	left_center
atoday.org	left_center
kentwired.com	left_center
newsone.com	left_center
home.gazettenet.com	left_center
amnews.com	left_center
univision.com	left_center
abcnews.go.com	left_center
augustafreepress.com	left_center
espn.com	left_center
grist.org	left_center
delcotimes.com	left_center
bostonreview.net	left_center
nj.com	left_center
sctimes.com	left_center
thejustice.org	left_center
news.google.com	left_center
heartlandsignal.com	left_center
baptistnews.com	left_center
ksmu.org	left_center
npr.org	left_center
anamariecox.com	left_center
newscentermaine.com	left_center
theatlantavoice.com	left_center
berkshireeagle.com	left_center
onenationnews.com	left_center
todayschronic.com	left_center
nprillinois.org	left_center
usnews.com	left_center
washingtonmonthly.com	left_center
time.com	left_center
lifeafterhate.org	left_center
nbcnews.com	left_center
spokesman.com	left_center
gaytimes.co.uk	left_center
coloradosun.com	left_center
michigandaily.com	left_center
variety.com	left_center
people.com	left_center
axios.com	left_center
economist.com	left_center
bnc.tv	left_center
ajc.com	left_center
wnyc.org	left_center
state-journal.com	left_center
nbcconnecticut.com	left_center
them.us	left_center
washingtonpost.com	left_center
outinjersey.net	left_center
globalnews.ca	left_center
advocate.com	left_center
thegrio.com	left_center
wyomingpublicmedia.org	left_center
gaycitynews.com	left_center
wsfa.com	left_center
go.tiffinohio.net	left_center
persuasion.community	left_center
bet.com	left_center
wvpe.org	left_center
northcountrypublicradio.org	left_center
theguardian.com	left_center
desmog.com	left_center
northjersey.com	left_center
mystatesman.com	left_center
nytimes.com	left_center
lehighvalleylive.com	left_center
miamiherald.com	left_center
vcij.org	left_center
snopes.com	left_center
timescall.com	left_center
middletownpress.com	left_center
usatoday.com	left_center
eastbaytimes.com	left_center
alreporter.com	left_center
americanpress.com	left_center
mprnews.org	left_center
kark.com	left_center
southfloridagaynews.com	left_center
freep.com	left_center
capitalandmain.com	left_center
bustle.com	left_center
noahpinion.substack.com	left_center
latimes.com	left_center
washingtonblade.com	left_center
lailluminator.com	left_center
wfyi.org	left_center
herald-dispatch.com	left_center
chicago.suntimes.com	left_center
braverangels.org	left_center
wxow.com	left_center
hartfordbusiness.com	left_center
rand.org	left_center
bloomberg.com	left_center
wrkf.org	left_center
yahoo.com	left_center
northcarolinahealthnews.org	left_center
nbcsandiego.com	left_center
fas.org	left_center
umnews.org	left_center
illinoisnewsroom.org	left_center
registercitizen.com	left_center
indyweek.com	left_center
kfgo.com	left_center
apnews.com	left_center
attitude.co.uk	left_center
dailynorthwestern.com	left_center
grid.news	left_center
premierchristian.news	left_center
wmnf.org	left_center
fridainsight.substack.com	left_center
truthorfiction.com	left_center
theonion.com	left_center
civilsquared.org	left_center
relevantmagazine.com	left_center
wilx.com	center
pvtimes.com	center
swoknews.com	center
sun-sentinel.com	center
bismarcktribune.com	center
kgw.com	center
newslit.org	center
kalw.org	center
texasstandard.org	center
lowndessignal.com	center
ksro.com	center
pennlive.com	center
panolawatchman.com	center
leadershipnowproject.org	center
wtae.com	center
scotusblog.com	center
abqjournal.com	center
dukechronicle.com	center
harrisondaily.com	center
kyivindependent.com	center
delawareonline.com	center
michiganadvance.com	center
techcrunch.com	center
ketr.org	center
staugustine.com	center
oklahoman.com	center
cbsaustin.com	center
coffeepartyusa.com	center
nola.com	center
wlns.com	center
williamreusch.com	center
starvedrock.media	center
mariettatimes.com	center
wkar.org	center
philasun.com	center
mountainstatespotlight.org	center
diplomaticourier.com	center
heraldnews.com	center
wnky.com	center
sciencedaily.com	center
unherd.com	center
statesmanjournal.com	center
irishtimes.com	center
kansascity.com	center
theindyonline.com	center
marekbros.com	center
eurekalert.org	center
kaaltv.com	center
edweek.org	center
lowellsun.com	center
azcentral.com	center
millennialaction.org	center
nbcchicago.com	center
central.newschannelnebraska.com	center
post-gazette.com	center
sfcg.org	center
dvalnews.com	center
corsicanadailysun.com	center
timesnews.net	center
courant.com	center
nationalinterest.org	center
chalkbeat.org	center
houstonchronicle.com	center
hamptonroadsmessenger.com	center
wdio.com	center
inmenlo.com	center
newschannel10.com	center
haysfreepress.com	center
easttexasradio.com	center
times-georgian.com	center
oregonlive.com	center
courier-tribune.com	center
thegeorgiasun.com	center
star-telegram.com	center
midweek.com	center
wtvr.com	center
qu.edu	center
theaugustapress.com	center
csmonitor.com	center
wfmz.com	center
kansas.com	center
portasouthjetty.com	center
kiro7.com	center
jacksonsun.com	center
annistonstar.com	center
joerogan.com	center
mexicodailypost.com	center
telegram.com	center
starbeacon.com	center
times-news.com	center
okcfriday.com	center
capegazette.com	center
delawarepublic.org	center
unionleader.com	center
wbrc.com	center
palmbeachnewscentral.com	center
renonr.com	center
heraldbulletin.com	center
theleafchronicle.com	center
theolympian.com	center
newschannel6now.com	center
greenfieldreporter.com	center
news.mit.edu	center
sunews.net	center
therepublicannews.com	center
wjon.com	center
ballotpedia.org	center
dl-online.com	center
themonroesun.com	center
ardmoreite.com	center
cbs58.com	center
richfieldreaper.com	center
953mnc.com	center
trib.com	center
wdiy.org	center
firstcoastnews.com	center
niemanlab.org	center
nevadacurrent.com	center
malheurenterprise.com	center
providencejournal.com	center
opb.org	center
semissourian.com	center
thewesterlysun.com	center
charlestoncitypaper.com	center
whnt.com	center
centraljersey.com	center
nautil.us	center
wbur.org	center
clarionledger.com	center
clintonherald.com	center
dailycorinthian.com	center
timberlakesouthdakota.com	center
westhawaiitoday.com	center
harlanenterprise.net	center
actionnewsjax.com	center
kunm.org	center
woai.iheart.com	center
starherald.com	center
thebusinesstimes.com	center
thejoltnews.com	center
click2houston.com	center
narrativesproject.com	center
bipartisanpolicy.org	center
nicd.arizona.edu	center
denvergazette.com	center
irvingweekly.com	center
alabamanewscenter.com	center
elpasotimes.com	center
wfsb.com	center
nbc29.com	center
limaohio.com	center
keyt.com	center
yorkdispatch.com	center
washdiplomat.com	center
iowastatedaily.com	center
news.crunchbase.com	center
kare11.com	center
news8000.com	center
boisestatepublicradio.org	center
morganmessenger.com	center
wmur.com	center
wpkyonline.com	center
kentreporter.com	center
gainesville.com	center
aberdeennews.com	center
boston.com	center
muscatinejournal.com	center
arkansasbusiness.com	center
news.wttw.com	center
uppermichiganssource.com	center
wacotrib.com	center
pressregister.com	center
crosstimbersgazette.com	center
foxsanantonio.com	center
joplinglobe.com	center
seguintoday.com	center
culturalevolution.org	center
knoxnews.com	center
kesq.com	center
brushnewstribune.com	center
patriotledger.com	center
dallas.culturemap.com	center
mpr.org	center
texomashomepage.com	center
fox59.com	center
baptiststandard.com	center
wral.com	center
lmtribune.com	center
kstp.com	center
twincitytimes.com	center
mywabashvalley.com	center
denverpost.com	center
thenewstribune.com	center
newportri.com	center
wsj.com	center
newjerseyglobe.com	center
woodtv.com	center
thebellows.org	center
erraticus.co	center
nwahomepage.com	center
nhpr.org	center
ksla.com	center
problemsolverscaucus.house.gov	center
fairmontsentinel.com	center
heraldbanner.com	center
mississippivalleypublishing.com	center
plaqueminesgazette.com	center
minnesotamonthly.com	center
sfstandard.com	center
moabtimes.com	center
connectionnewspapers.com	center
themarkup.org	center
thisweekinworcester.com	center
winonatimes.com	center
hawaiinewsnow.com	center
meadecountyky.com	center
fox56news.com	center
washingtoncountyinsider.com	center
wrfalp.com	center
newdiscourses.com	center
timcast.com	center
detroitnews.com	center
hawaiitribune-herald.com	center
vindy.com	center
themonmouthjournaleastern.com	center
barnstablepatriot.com	center
localnews8.com	center
northescambia.com	center
yumasun.com	center
4029tv.com	center
tri-cityherald.com	center
poststar.com	center
fox42kptm.com	center
statnews.com	center
norfolkdailynews.com	center
realclearpolitics.com	center
communityconversationsforamerica.org	center
phoenixnewtimes.com	center
rogueriverpress.com	center
myrtlebeachonline.com	center
gilmermirror.com	center
glennloury.substack.com	center
boisedev.com	center
whyy.org	center
newsdakota.com	center
trentonian.com	center
baltimoresun.com	center
erienewsnow.com	center
spotonillinois.com	center
orlandosentinel.com	center
wibw.com	center
commercecitysentinel.com	center
votesmart.org	center
nysfocus.com	center
dailytrib.com	center
ddtonline.com	center
derrynews.com	center
provincetownindependent.org	center
commonsense.news	center
avenuenews.com	center
religionnews.com	center
weatherforddemocrat.com	center
indystar.com	center
houstonpublicmedia.org	center
nbc4i.com	center
inthistogetheramerica.org	center
ctpublic.org	center
postindependent.com	center
borderreport.com	center
homenewshere.com	center
courierpostonline.com	center
smerconish.com	center
minnpost.com	center
ijpr.org	center
kxii.com	center
wesh.com	center
herald-review.com	center
timesleader.com	center
knsiradio.com	center
addisonindependent.com	center
kilgorenewsherald.com	center
pjstar.com	center
parkrecord.com	center
peterboghossian.com	center
apa.org	center
boston25news.com	center
wane.com	center
callnewspapers.com	center
thesouthafrican.com	center
galvnews.com	center
superiortelegram.com	center
smarthernews.com	center
alaskalandmine.com	center
kwch.com	center
cincinnati.com	center
bridgemi.com	center
silive.com	center
dailyyonder.com	center
helenair.com	center
firstdraftnews.org	center
springfieldnewssun.com	center
wcrecord.com	center
taipeitimes.com	center
trains.com	center
constitutioncenter.org	center
montanakaimin.com	center
samharris.org	center
nationalgeographic.com	center
mediavillage.com	center
isaiahanthony.com	center
fairforall.org	center
wishtv.com	center
newyorkdailygazette.com	center
newstimes.com	center
factcheck.thedispatch.com	center
beaconjournal.com	center
heraldextra.com	center
techxplore.com	center
theharwoodinstitute.org	center
heraldnet.com	center
foreignaffairs.com	center
seedsofpeace.org	center
nutfieldnews.net	center
crowdpac.com	center
dailyprogress.com	center
missourinet.com	center
myleaderpaper.com	center
theworldlink.com	center
ktvq.com	center
pasadenastarnews.com	center
forwardparty.com	center
argusleader.com	center
recordcourier.com	center
emporiagazette.com	center
nwitimes.com	center
newstribune.com	center
wowktv.com	center
risenmagazine.com	center
pantagraph.com	center
clickorlando.com	center
haaretz.com	center
monvalleyindependent.com	center
richlandsource.com	center
journalistsresource.org	center
ajlamesa.medium.com	center
wapt.com	center
thebullfinchgroup.com	center
jhnewsandguide.com	center
wktv.com	center
greenwichtime.com	center
wizmnews.com	center
civilbeat.org	center
californiaexaminer.net	center
oilprice.com	center
app.com	center
thespectrum.com	center
therepublic.com	center
indiana105.com	center
whoradio.iheart.com	center
peakofohio.com	center
capecod.com	center
dnronline.com	center
reuters.com	center
expressnews.com	center
kfoxtv.com	center
cleveland.com	center
abc12.com	center
theadanews.com	center
peninsulaclarion.com	center
king5.com	center
13newsnow.com	center
readtangle.com	center
wkbn.com	center
hinghamanchor.com	center
california18.com	center
bnd.com	center
dailyjournal.net	center
americanvalues.org	center
thevermontstandard.com	center
fortune.com	center
pri.org	center
homernews.com	center
tampabay.com	center
kxxv.com	center
klin.com	center
observer.com	center
timesunion.com	center
floridainsider.com	center
newjerseyhills.com	center
dispatch.com	center
news4sanantonio.com	center
burlingtoncountytimes.com	center
kbnd.com	center
berkshireeagle.com	center
tucson.com	center
inforum.com	center
justsecurity.org	center
deseret.com	center
newburyportnews.com	center
newhampshirebulletin.com	center
virginiabusiness.com	center
ivn.us	center
washingtoncitypaper.com	center
thecalifornian.com	center
ketv.com	center
krdo.com	center
calmatters.org	center
mypanhandle.com	center
wkrn.com	center
williamsonherald.com	center
redlandsdailyfacts.com	center
san.com	center
arizona.votebeat.org	center
sj-r.com	center
avoyellestoday.com	center
newspressnow.com	center
wyomingnewsnow.tv	center
uscourts.gov	center
christianheadlines.com	center
columbian.com	center
nomenugget.com	center
newsday.com	center
1011now.com	center
spotonflorida.com	center
soapboxmedia.com	center
wivb.com	center
opensecrets.org	center
our.news	center
mlive.com	center
thenevadaindependent.com	center
minnesotasnewcountry.com	center
nicholaschronicle.com	center
news-herald.com	center
redlakenationnews.com	center
blufftonicon.com	center
capitolweekly.net	center
carriagetownenews.com	center
fortworthbusiness.com	center
27east.com	center
justthenews.com	center
dailynews.com	center
northjersey.com	center
kvoe.com	center
lacrossetribune.com	center
wisconsinrapidstribune.com	center
keloland.com	center
siouxlandproud.com	center
gasiantimes.com	center
publicnewsservice.org	center
votebeat.org	center
kark.com	center
knkx.org	center
seeleylake.com	center
daryldavis.com	center
bridgingdivides.princeton.edu	center
wmdt.com	center
qz.com	center
marketwatch.com	center
myarklamiss.com	center
wcpo.com	center
redefinedonline.org	center
virginiamercury.com	center
omaha.com	center
ktvz.com	center
southcarolinapublicradio.org	center
pewresearch.org	center
democratandchronicle.com	center
pctribune.com	center
voanews.com	center
floridadaily.com	center
commongroundcommittee.org	center
news-leader.com	center
mexiconewsdaily.com	center
stimson.org	center
issueone.org	center
citizentribune.com	center
mltnews.com	center
kvrr.com	center
nfrpp.org	center
manilatimes.net	center
wpr.org	center
riponpress.com	center
keyc.com	center
wcvb.com	center
fox13seattle.com	center
thecheyennepost.com	center
lancasteronline.com	center
whdh.com	center
timesdaily.com	center
fredericknewspost.com	center
wxyz.com	center
franklinfavorite.com	center
journal-news.com	center
fox29.com	center
c-span.org	center
kearneyhub.com	center
fronterasdesk.org	center
neworleanscitybusiness.com	center
tulsaworld.com	center
bonnercountydailybee.com	center
cecildaily.com	center
wfla.com	center
minnesotanativenews.org	center
kwhi.com	center
bdtonline.com	center
wkyc.com	center
wrde.com	center
12newsnow.com	center
independentmail.com	center
tallahassee.com	center
eplocalnews.org	center
tpt.org	center
winchesterstar.com	center
thepenobscottimes.com	center
sgfcitizen.org	center
catholicnews.com	center
oklahomawatch.org	center
californiaglobe.com	center
bradfordera.com	center
dailymontanan.com	center
heartoftherockiesradio.com	center
delawaretoday.com	center
kttc.com	center
capitolhillseattle.com	center
palestineherald.com	center
thecurrent.org	center
marshallnewsmessenger.com	center
koaa.com	center
shreveporttimes.com	center
dallasnews.com	center
eptrail.com	center
fayettevilleflyer.com	center
kens5.com	center
columbiamissourian.com	center
komonews.com	center
gao.gov	center
journaltimes.com	center
civilpolitics.org	center
thekentuckydaily.com	center
mtstandard.com	center
abc7ny.com	center
ibj.com	center
upi.com	center
kff.org	center
jubileemedia.com	center
dailynorseman.com	center
ktoo.org	center
theadvocate.com	center
checkyourfact.com	center
concordmonitor.com	center
psychologicalscience.org	center
ottumwacourier.com	center
postregister.com	center
journalgazette.net	center
alaskapublic.org	center
dailybreeze.com	center
sgvtribune.com	center
theday.com	center
idahopress.com	center
sanjuanjournal.com	center
volanteonline.com	center
dailycardinal.com	center
myfox28columbus.com	center
lafourchegazette.com	center
newtrals.com	center
fredericksburg.com	center
klkntv.com	center
japantimes.co.jp	center
alamosanews.com	center
wcia.com	center
wtvbam.com	center
iredellfreenews.com	center
idsnews.com	center
psychcentral.com	center
taibbi.substack.com	center
opelikaobserver.com	center
coloradonewsline.com	center
nature.com	center
stltoday.com	center
registerguard.com	center
tennessean.com	center
adn.com	center
kcfmradio.com	center
wbay.com	center
worthynews.com	center
rutlandherald.com	center
hastingstribune.com	center
hindustantimes.com	center
idahostatesman.com	center
southwestarkansasradio.com	center
timesargus.com	center
hngnews.com	center
fox21online.com	center
greenbaypressgazette.com	center
wgal.com	center
newsobserver.com	center
thegeorgiavirtue.com	center
myrye.com	center
georgiarecorder.com	center
dailyadvance.com	center
dentonrc.com	center
roanoke.com	center
thewashingtonsun.com	center
fox4kc.com	center
sfweekly.com	center
smithsonianmag.com	center
benewsjournal.com	center
kuer.org	center
humanetech.com	center
thehill.com	center
jsonline.com	center
fox17online.com	center
investopedia.com	center
bemidjipioneer.com	center
wlbt.com	center
eastidahonews.com	center
heterodoxacademy.org	center
cnbc.com	center
cuindependent.com	center
wtkr.com	center
abc57.com	center
cbs4local.com	center
KQED.org	center
desmoinesregister.com	center
kbzk.com	center
959watd.com	center
thedailyiberian.com	center
poynter.org	center
billingsgazette.com	center
wispolitics.com	center
nbc15.com	center
twincities.com	center
ctmirror.org	center
idahostatejournal.com	center
triton.news	center
salina.com	center
calwatchdog.com	center
anchoragepress.com	center
civichealthproject.org	center
searchlightnm.org	center
wbbjtv.com	center
amarillopioneer.com	center
news.wjct.org	center
floridatoday.com	center
kgns.tv	center
militarytimes.com	center
mycoloradospringsnews.com	center
chicagotribune.com	center
jacksonville.com	center
thederrick.com	center
ktsa.com	center
capitol-beat.org	center
northernvirginiamag.com	center
wndu.com	center
montanarightnow.com	center
wyso.org	center
whopam.com	center
mycentraloregon.com	center
arstechnica.com	center
stgeorgeutah.com	center
wktn.com	center
wrdw.com	center
9and10news.com	center
salemnews.net	center
indianagazette.com	center
kshb.com	center
dakotafreepress.com	center
kplctv.com	center
newrockfordtranscript.com	center
sent-trib.com	center
indianapolisrecorder.com	center
baptistpress.com	center
spokesman-recorder.com	center
arcdigital.media	center
minnesotanewsnetwork.com	center
nmpolitics.net	center
wyomingnews.com	center
abc11.com	center
vermontpublic.org	center
lawfareblog.com	center
ourcivicgenius.org	center
indynewssource.com	center
coveringkaty.com	center
winonadailynews.com	center
alleghanynews.com	center
joelosteen.com	center
arkvalleyvoice.com	center
nolabels.org	center
baytobaynews.com	center
hawaiipublicradio.org	center
wgvunews.org	center
capecodtimes.com	center
nbc12.com	center
drudgereport.com	center
naplesnews.com	center
scrippsnews.com	center
albertmohler.com	center
shorenewsnetwork.com	center
denvernorthstar.com	center
mauinews.com	center
indianapublicmedia.org	center
wbko.com	center
lostcoastoutpost.com	center
thestar.com	center
kake.com	center
cn2.com	center
live5news.com	center
news.wgbh.org	center
itemonline.com	center
columbiatribune.com	center
ottumwapost.com	center
verifythis.com	center
wric.com	center
joycemeyer.org	center
12news.com	center
columbiabasinherald.com	center
kicdam.com	center
cardinalnews.org	center
radioiowa.com	center
minnlawyer.com	center
amarillo.com	center
bbc.com	center
elpasomatters.org	center
lcsun-news.com	center
wbir.com	center
wdel.com	center
hattiesburgamerican.com	center
indepthnh.org	center
texasinsider.org	center
myhighplains.com	center
nevadaappeal.com	center
bendbulletin.com	center
mvtimes.com	center
burlingtonfreepress.com	center
rapidcityjournal.com	center
incentfit.com	center
kgun9.com	center
witn.com	center
hccommunityjournal.com	center
cjonline.com	center
moreincommon.com	center
floydct.com	center
aarp.org	center
channel3000.com	center
alaskasnewssource.com	center
djournal.com	center
wfae.org	center
butlerradio.com	center
nhregister.com	center
rockwallheraldbanner.com	center
southbendtribune.com	center
ctpost.com	center
spotonalabama.com	center
theprescotttimes.com	center
tylerpaper.com	center
wboy.com	center
wtol.com	center
local12.com	center
cbs17.com	center
fortbendstar.com	center
yoursun.com	center
gillettenewsrecord.com	center
theglobeandmail.com	center
floridapolitics.com	center
justfacts.com	center
kmaland.com	center
dailynebraskan.com	center
heavy.com	center
stamfordadvocate.com	center
dailyherald.com	center
misinforeview.hks.harvard.edu	center
gazette.com	center
kentucky.com	center
mycentraljersey.com	center
codyenterprise.com	center
wakeuptopolitics.com	center
rustonleader.com	center
wickedlocal.com	center
gaybuzzer.com	center
postbulletin.com	center
plainsman.com	center
newjerseylocalnews.com	center
delawarebusinesstimes.com	center
wrangellsentinel.com	center
theappeal.org	center
kenoshanews.com	center
theberkshireedge.com	center
mansfieldnewsjournal.com	center
alabamanews.net	center
cbs2iowa.com	center
wired.com	center
krem.com	center
weirtondailytimes.com	center
montanafreepress.org	center
paintsvilleherald.com	center
timesherald.com	center
bozemandailychronicle.com	center
missoulian.com	center
chicago.chalkbeat.org	center
wislawjournal.com	center
prt.nwaonline.com	center
wafb.com	center
sbsun.com	center
kwtx.com	center
plaindealer.com	center
crossroadstoday.com	center
eastvillagemagazine.org	center
thestate.com	center
news.wfsu.org	center
themessenger.com	center
wwaytv3.com	center
palmbeachpost.com	center
wrbiradio.com	center
arabamericannews.com	center
clickondetroit.com	center
thepublicopinion.com	center
wjhg.com	center
golocalprov.com	center
democratherald.com	center
timesonline.com	center
kentuckytoday.com	center
tuscaloosanews.com	center
youarecurrent.com	center
wtnh.com	center
delmarvanow.com	center
aikenstandard.com	center
ktbs.com	center
coindesk.com	center
cnet.com	center
eastvalleytribune.com	center
saturdayeveningpost.com	center
watfordcitynd.com	center
coloradopolitics.com	center
whittierdailynews.com	center
usforacle.com	center
wdtn.com	center
albertleatribune.com	center
lakehighlands.advocatemag.com	center
stripes.com	center
oaoa.com	center
jamestownpress.com	center
louisianaradionetwork.com	center
shanicejones.com	center
kentuckynewera.com	center
redandblack.com	center
alaskacommons.com	center
hpenews.com	center
dailyiowan.com	center
kuow.org	center
northwrightcounty.today	center
allaboutarizonanews.com	center
anneapplebaum.com	center
iowapublicradio.org	center
triblive.com	center
southernminnesotanews.com	center
ellsworthamerican.com	center
oaklandside.org	center
seattletimes.com	center
brazilian.report	center
kmvt.com	center
nonpareilonline.com	center
nationaljournal.com	center
fivethirtyeight.com	center
palladiummag.com	center
westtexastribune.org	center
krtv.com	center
nashvillepost.com	center
connecticut.news12.com	center
coveleaderpress.com	center
glencoenews.com	center
pilotonline.com	center
times-standard.com	center
pressofatlanticcity.com	center
wvpublic.org	center
6abc.com	center
13abc.com	center
phys.org	center
pressherald.com	center
brookings.edu	center
news4jax.com	center
readingeagle.com	center
forbes.com	center
wgntv.com	center
dailybulletin.com	center
newarkpostonline.com	center
kentuckygazette.com	center
newsnationnow.com	center
stormlake.com	center
am1100theflag.com	center
ktlo.com	center
centralmaine.com	center
thetandd.com	center
townsquaredelaware.com	center
wkow.com	center
mississippitoday.org	center
theblackdetour.com	center
beaumontenterprise.com	center
staradvertiser.com	center
nmindepth.com	center
gallatinnews.com	center
weeklypacket.com	center
wemu.org	center
lifehacker.com	center
southarkansassun.com	center
ibtimes.com	center
freakonomics.com	center
countable.us	center
churchleaders.com	center
myhcicon.com	center
kansaspublicradio.org	center
centerpostdispatch.com	center
gazettetimes.com	center
foxnebraska.com	center
scdailypress.com	center
cookpolitical.com	center
poughkeepsiejournal.com	center
fox9.com	center
cbs7.com	center
newsweek.com	center
ffxnow.com	center
news5cleveland.com	center
dw.com	center
whio.com	center
barrons.com	center
sparkstrib.com	center
kvia.com	center
austindailyherald.com	center
courierpress.com	center
georgialawnews.com	center
kcbeacon.org	center
ncsl.org	center
michiganradio.org	center
hutchnews.com	center
cleveland19.com	center
gainesvilleregister.com	center
koin.com	center
nvdaily.com	center
thv11.com	center
jewishinsider.com	center
freestonecountytimesonline.com	center
gothamist.com	center
leadertelegram.com	center
colebrookchronicle.weebly.com	center
abc27.com	center
daily.jstor.org	center
andystanley.com	center
buffalonews.com	center
lawandcrime.com	center
richardsontoday.com	center
dcist.com	center
factcheck.org	center
fox16.com	center
lufkindailynews.com	center
alaska-native-news.com	center
wdsu.com	center
wtop.com	center
carnegieendowment.org	center
lcnme.com	center
kmov.com	center
tristatehomepage.com	center
louisianaweekly.com	center
currentargus.com	center
yakimaherald.com	center
fox5atlanta.com	center
worldwildlife.org	center
pnj.com	center
politicalempathyproject.org	center
hotsr.com	center
examiner-enterprise.com	center
santafenewmexican.com	center
timesfreepress.com	center
swnews4u.com	center
tmj4.com	center
thefulcrum.us	center
patch.com	center
nwaonline.com	center
statesman.com	center
wvnews.com	center
christiannewsnow.com	right_center
washingtontimes.com	right_center
babylonbee.com	right_center
rebeccasheehan.substack.com	right_center
manhattan-institute.org	right_center
intellectualconservative.com	right_center
davidfrum.com	right_center
mydakotan.com	right_center
goodnewsmag.org	right_center
catholicdigest.com	right_center
theepochtimes.com	right_center
mises.org	right_center
rt.com	right_center
tabletmag.com	right_center
christianitytoday.com	right_center
upward.news	right_center
nypost.com	right_center
thefiscaltimes.com	right_center
hotair.com	right_center
1819news.com	right_center
judicialwatch.org	right_center
wyofile.com	right_center
kten.com	right_center
fee.org	right_center
outkick.com	right_center
thetexan.news	right_center
mercatus.org	right_center
spiked-online.com	right_center
ocregister.com	right_center
reason.org	right_center
riponadvance.com	right_center
carolinajournal.com	right_center
telegraph.co.uk	right_center
thepostmillennial.com	right_center
nationalpost.com	right_center
desiringgod.org	right_center
cowboystatedaily.com	right_center
leesburgtoday.com	right_center
gop.com	right_center
bostonherald.com	right_center
zerohedge.com	right_center
heritage.org	right_center
rove.com	right_center
atlasone.org	right_center
independent.org	right_center
washingtonexaminer.com	right_center
christianpost.com	right_center
reason.com	right_center
eviemagazine.com	right_center
foxbusiness.com	right_center
marylandreporter.com	right_center
americanmind.org	right_center
capitalresearch.org	right_center
bluelivesmatter.blue	right_center
dailypress.com	right_center
vaticannews.va	right_center
acc.eco	right_center
nfib.com	right_center
steamboatinstitute.org	right_center
penncapital-star.com	right_center
richmond.com	right_center
ntd.com	right_center
investors.com	right_center
johnathonheld.com	right_center
thedispatch.com	right_center
cc.org	right_center
marionicolais.com	right_center
pe.com	right_center
rubio.senate.gov	right_center
thehighwire.com	right_center
cato.org	right_center
iowatorch.com	right_center
thelibertarianrepublic.com	right_center
ksl.com	right
flvoicenews.com	right
rightsidenews.com	right
westernjournalism.com	right
tpusa.com	right
frontpagemag.com	right
ralphbenko.com	right
atlasnetwork.org	right
aim.org	right
infowars.com	right
inacow.com	right
conservativehq.com	right
nationalreview.com	right
theblaze.com	right
projectveritas.com	right
thegatewaypundit.com	right
virtueonline.org	right
cnsnews.com	right
bizpacreview.com	right
rightwingnews.com	right
dailycaller.com	right
mrc.org	right
themainewire.com	right
theresurgent.com	right
ncregister.com	right
theimaginativeconservative.org	right
tuckercarlson.com	right
thelibertycafe.wordpress.com	right
seanmcdowell.org	right
americanthinker.com	right
revolver.news	right
conservative.org	right
thefederalist.com	right
foxnews.com	right
dailywire.com	right
georgiastarnews.com	right
ijr.com	right
atr.org	right
www1.cbn.com	right
sarahpalin.com	right
amgreatness.com	right
alaskawatchman.com	right
floridacapitalstar.com	right
thenationalpulse.com	right
wng.org	right
spectatorworld.com	right
blackcommunitynews.com	right
michellemalkin.com	right
diamondandsilkinc.com	right
christiannews.net	right
voiceofchid.com	right
freebeacon.com	right
weeklystandard.com	right
bearingdrift.com	right
pacificresearch.org	right
churchmilitant.com	right
city-journal.org	right
prageru.com	right
ammo.com	right
townhall.com	right
newsbusters.org	right
breitbart.com	right
thecollegefix.com	right
taylormarshall.com	right
peggynoonan.com	right
charismamag.com	right
anncoulter.com	right
catholicnewsagency.com	right
theamericanconservative.com	right
spectator.org	right
wnd.com	right
newsmax.com	right
dailymail.co.uk	right
themichiganstar.com	right
keepingitright.blogspot.com	right
brownstone.org	right
patriotpost.us	right
dailycitizen.focusonthefamily.com	right
gop.gov	right
commentary.org	right
standamerica.us	right
nysun.com	right
candaceowens.com	right
jesseleepeterson.com	right
africanamericanconservatives.com	right
alphanews.org	right
lincolnproject.us	allsides
storycorps.org	allsides
allsides.com	allsides
counterpointing.com	allsides
theflipside.io	allsides
dividedwefall.org	allsides
abridgenews.com	allsides
mismatch.org	allsides
braverangels.org	allsides
gell.com	allsides
igmchicago.org	allsides
bridgeusa.org	allsides
thethreadweekly.com	allsides
suspendbeliefpodcast.com	allsides
redbluedictionary.org	allsides
